1 55
 ###########
##         #
#          #
# $ $ #    #
#. @  #   .#
############