100 1 5
############
#  .#   .##
#         #
#   $$$   #
###      ###
#    #  #### 
#  .@   #
#########
