100 2 
###########
#  .       #
#####      #
#@  ##$    #
 #   $   ###
 # .      ##
 #         #
 ###########
