1 29
###########
##        #
#   * $   #
#    ###  #
#   ###   #
#    ##   #
#.    @   #
###########