3 4
#########
#@    #.#
#     #.#
#  $  # #
# $#    #
#       #
######### 
