23 5
#############
#    #      #
#  $       .#
#    #     .#
#    #      #
# @ $########
#    #      #      
#############    