3
#######
#  .  #
#     #
#     #
### ###
#     #
#   $ #
###   #
# @   #
#######